11111111111111111111111111111111111
1E000000000000000000000000000I00001
10101111111111111111111111111111111
10111111111111111111I1I111111111111
10111111111111000111010100011111111
10111000011I10110111010111011111I11
1011101101101111011101011101111C011
101011111111110001111101111P1100001
10111111111111111111111111101101111
10000000000000000000000I00000000001
11111111111111111111111111111111111