1111111111111111111111111111
1C00000000000110C000I0C00001
1011110111110110111110111101
1C111101111101101111101111C1
1011110111110110111110111101
100000000I00000000C000I00001
1011110110111111110110111101
1011110110111111110110111101
100000011000011000011000I001
1111110111110110111110111111
1111110111110110111110111111
1111110100000I00000010111111
1111110101111001111010111111
10CCCCCCC100000P0010C0C0CCE1
1111110101111111111010111111
1111110100000000000010111111
1111111111111111111111111111