111111111111111111111111111
1P0000000000000000000000001
1011111111111100000CCC11101
10000000I000000000110000001
100000000000000000110000001
100000000001000000000100001
1011111100011101100001001E1
100000000000000000000111111
111111111111111111111111111
101010101111111111111111111
111111111111111111111111111