111111111111111111111111111111
1P0000000000000000000000000001
101111111111110000000011100001
100000000000000000110000000001
100000000000000000110000000001
100000000001000000000100000001
101111110001110110000010010001
100000000000000000000111110001
101111110000100000000100000001
101E00010000100000000000000001
101000100001001111111100000001
10100001000010000000000000I001
101000010000111111111000000001
1000000000100CCCC0000000000001
100000110000100110000110000001
100000110000100000000000000001
100000000100000000000000000001
111111111111111111111101111101
101010101010111111111111111111
111111111111111111111111111111