111111111111111111111111111111111111111111
10CC00E00000000001000100000000000000000001
1000P0010010000010100100000000000000000001
101001010010000000100101111100011101110001
101001010010000010100100010000010000000001
101001010010000010100100010000010000000001
101001010010000010100100010000010000000001
101000010010000010100100000000010000000001
101001010010000010100111111111110111110001
101001010010000010100100000000000000000001
101001000010000010100100000000000000000001
101001010010000010100100000000011111000001
101001010010000010100100000000000000000001
101001010010000010100100000000000100000001
101001010011100010100100000000000110000101
101001000010010010100100000000000000011001
101001010010100000100100000000010000100001
111001001010101000100111111111100001000001
100000000000100000000000000000000000000001
111111111111111111111111111111111111111111