11111111111111111111111111111111111111111
10000000000000000E000000000000000000000P1
10C0C0C000000C0000C00C00CC00C0C0000C00001
10100101001000001010010000000000000000001
10100101001000001010010000000001111100001
10100101001000001010010000000000000000001
11111111111111111111111111111111111111111