111111111111111
1000001000C0001
10000000P000001
110111000011111
1E0000000011111
111111111111111