111111111
1P0C00001
1000010E1
100C00001
111111111