11111111111111111111
1010E0C00000P0000C01
11111111111111111111