1111111111111
10C10000000C1
100001000C001
1P0C01E000001
1111111111111
1101010100001
1101110111101
1100000100001
1111110101111
1111110101101
1111110101111
1111110100001
1111111111111
1111111111111